○○○○○○○○○○
○○●○●○○○○○
○○○●●●○○○○
○○●○●○○○○○
○○○○○○○○○○
○○○○●○○○○○
○○○○○●○○○○
○○○○○○●○○○
○○○○○○○○○○
○○○○○○○○○○
